11111111111111111111111111111111111111111111111
10000010000000000000011000001000000000000000001
10000000000011000000000000000000000000001100001
10000010000000000000000000000000000000000000001
10000000000100000000000100000000010000000001001
10010000000000001000000000000000000100000000101
10000000001000000000011000000000000110000010001
10001111111111111100000000000000000100000000001
10000000000000000000000000000000000100000010001
10000000000000000000000100000011111100000000001
10000000000011000000000000000000000000000000001
10000000000000000110000000000000000111110000001
10000100000000000000000000000000000000010000001
10000000000000000000001111111110000000010000001
10000000100000000000000000000000000000010000001
10000000100000000000000000010000000000000000001
10000000100111100000000000001000000000000000001
10000000100100000000000000000000000001000010001
10000000100100000000000000000000000010000011101
10000000111100000000000000000000000000000000101
10000000000000000000000000111000111111000000101
10000100000000000111000000100000000001000000001
10000000000000000000000000100000000000000000001
11111111111111111111111111111111111111111111111